1111111111111
1CC1CCCCCCCC1
1CC0C11111CC1
1PC001ECCCCC1
1111111111111
