1111111111111111
1C010000000C00C1
1000011111000001
10P011E000000CM1
1111111111111111
